STATE_NAME,Lg_Dist_Code,DISTRICT_NAME,MICRO,SMALL,MEDIUM,Total,Last_Updated
ANDHRA PRADESH,745,Alluri Sitharama Raju,1,0,0,1,23-04-2022
ANDHRA PRADESH,744,Anakapalli,22,0,0,22,23-04-2022
ANDHRA PRADESH,502,ANANTHAPUR,11885,312,11,12208,23-04-2022
ANDHRA PRADESH,753,Annamayya,13,0,0,13,23-04-2022
ANDHRA PRADESH,750,Bapatla,9,1,0,10,23-04-2022
ANDHRA PRADESH,503,CHITOOR,12515,436,19,12970,23-04-2022
ANDHRA PRADESH,505,EAST GODAVARI,16222,758,51,17031,23-04-2022
ANDHRA PRADESH,748,Eluru,32,1,0,33,23-04-2022
ANDHRA PRADESH,506,GUNTUR,15128,740,61,15929,23-04-2022
ANDHRA PRADESH,746,Kakinada,37,1,0,38,23-04-2022
ANDHRA PRADESH,747,Konaseema,16,0,0,16,23-04-2022
ANDHRA PRADESH,510,KRISHNA,19932,1169,85,21186,23-04-2022
ANDHRA PRADESH,511,KURNOOL,12839,418,16,13273,23-04-2022
ANDHRA PRADESH,755,Nandyal,21,0,0,21,23-04-2022
ANDHRA PRADESH,749,NTR,30,1,0,31,23-04-2022
ANDHRA PRADESH,751,Palnadu,19,0,0,19,23-04-2022
ANDHRA PRADESH,743,Parvathipuram Manyam,3,0,0,3,23-04-2022
ANDHRA PRADESH,517,PRAKASAM,8829,284,8,9121,23-04-2022
ANDHRA PRADESH,515,SPSR NELLORE,10270,429,20,10719,23-04-2022
ANDHRA PRADESH,754,Sri Sathya Sai,20,0,0,20,23-04-2022
ANDHRA PRADESH,519,SRIKAKULAM,4232,149,7,4388,23-04-2022
ANDHRA PRADESH,752,Tirupati,25,1,0,26,23-04-2022
ANDHRA PRADESH,520,VISAKHAPATNAM,17062,1061,89,18212,23-04-2022
ANDHRA PRADESH,521,VIZIANAGARAM,4381,161,6,4548,23-04-2022
ANDHRA PRADESH,523,WEST GODAVARI,14353,725,77,15155,23-04-2022
ANDHRA PRADESH,504,Y.S.R,8642,321,16,8979,23-04-2022
ARUNACHAL PRADESH,628,ANJAW,24,0,0,24,23-04-2022
ARUNACHAL PRADESH,229,CHANGLANG,87,0,0,87,23-04-2022
ARUNACHAL PRADESH,230,DIBANG VALLEY,7,0,0,7,23-04-2022
ARUNACHAL PRADESH,231,EAST KAMENG,27,0,0,27,23-04-2022
ARUNACHAL PRADESH,232,EAST SIANG,102,2,0,104,23-04-2022
ARUNACHAL PRADESH,718,KAMLE,9,0,0,9,23-04-2022
ARUNACHAL PRADESH,677,KRA DAADI,15,0,0,15,23-04-2022
ARUNACHAL PRADESH,233,KURUNG KUMEY,25,1,0,26,23-04-2022
ARUNACHAL PRADESH,724,LEPARADA,9,0,0,9,23-04-2022
ARUNACHAL PRADESH,234,LOHIT,98,0,0,98,23-04-2022
ARUNACHAL PRADESH,666,LONGDING,17,0,0,17,23-04-2022
ARUNACHAL PRADESH,235,LOWER DIBANG VALLEY,43,1,0,44,23-04-2022
ARUNACHAL PRADESH,719,LOWER SIANG,26,0,0,26,23-04-2022
ARUNACHAL PRADESH,236,LOWER SUBANSIRI,176,2,0,178,23-04-2022
ARUNACHAL PRADESH,678,NAMSAI,41,0,0,41,23-04-2022
ARUNACHAL PRADESH,723,PAKKE KESSANG,5,0,0,5,23-04-2022
ARUNACHAL PRADESH,237,PAPUM PARE,731,47,9,787,23-04-2022
ARUNACHAL PRADESH,725,SHI YOMI,12,0,0,12,23-04-2022
ARUNACHAL PRADESH,679,SIANG,12,0,0,12,23-04-2022
ARUNACHAL PRADESH,238,TAWANG,41,2,0,43,23-04-2022
ARUNACHAL PRADESH,239,TIRAP,38,1,0,39,23-04-2022
ARUNACHAL PRADESH,240,UPPER SIANG,19,1,0,20,23-04-2022
ARUNACHAL PRADESH,241,UPPER SUBANSIRI,37,3,0,40,23-04-2022
ARUNACHAL PRADESH,242,WEST KAMENG,116,5,0,121,23-04-2022
ARUNACHAL PRADESH,243,WEST SIANG,45,3,0,48,23-04-2022
ASSAM,739,BAJALI,40,1,0,41,23-04-2022
ASSAM,616,BAKSA,924,9,1,934,23-04-2022
ASSAM,280,BARPETA,2135,62,4,2201,23-04-2022
ASSAM,705,Biswanath,844,21,0,865,23-04-2022
ASSAM,281,BONGAIGAON,1092,52,4,1148,23-04-2022
ASSAM,282,CACHAR,3343,135,7,3485,23-04-2022
ASSAM,708,CHARAIDEO,364,10,0,374,23-04-2022
ASSAM,612,CHIRANG,654,16,4,674,23-04-2022
ASSAM,283,DARRANG,4761,55,0,4816,23-04-2022
ASSAM,284,DHEMAJI,1634,26,1,1661,23-04-2022
ASSAM,285,DHUBRI,1422,43,2,1467,23-04-2022
ASSAM,286,DIBRUGARH,3129,163,4,3296,23-04-2022
ASSAM,299,DIMA HASAO,192,0,0,192,23-04-2022
ASSAM,287,GOALPARA,1119,35,2,1156,23-04-2022
ASSAM,288,GOLAGHAT,2183,54,1,2238,23-04-2022
ASSAM,289,HAILAKANDI,855,13,0,868,23-04-2022
ASSAM,709,HOJAI,843,31,1,875,23-04-2022
ASSAM,290,JORHAT,1941,141,7,2089,23-04-2022
ASSAM,291,KAMRUP,3138,100,13,3251,23-04-2022
ASSAM,618,KAMRUP METRO,8639,1139,130,9908,23-04-2022
ASSAM,292,KARBI-ANGELONG,823,15,0,838,23-04-2022
ASSAM,293,KARIMGANJ,1544,50,1,1595,23-04-2022
ASSAM,294,KOKRAJHAR,724,24,0,748,23-04-2022
ASSAM,295,LAKHIMPUR,1719,48,3,1770,23-04-2022
ASSAM,706,MAJULI,196,2,0,198,23-04-2022
ASSAM,296,MARIGAON,1355,15,1,1371,23-04-2022
ASSAM,297,NAGAON,2480,84,4,2568,23-04-2022
ASSAM,298,NALBARI,1264,33,1,1298,23-04-2022
ASSAM,300,SIVASAGAR,1380,87,5,1472,23-04-2022
ASSAM,301,SONITPUR,2167,72,12,2251,23-04-2022
ASSAM,707,SOUTH SALMARA MANCACHAR,121,2,0,123,23-04-2022
ASSAM,302,TINSUKIA,2644,127,9,2780,23-04-2022
ASSAM,617,UDALGURI,910,15,0,925,23-04-2022
ASSAM,710,WEST KARBI ANGLONG,152,0,0,152,23-04-2022
BIHAR,188,ARARIA,5025,139,3,5167,23-04-2022
BIHAR,611,ARWAL,791,19,0,810,23-04-2022
BIHAR,189,AURANGABAD,3339,70,4,3413,23-04-2022
BIHAR,190,BANKA,3765,35,1,3801,23-04-2022
BIHAR,191,BEGUSARAI,6988,178,14,7180,23-04-2022
BIHAR,192,BHAGALPUR,8163,188,9,8360,23-04-2022
BIHAR,193,BHOJPUR,3819,79,2,3900,23-04-2022
BIHAR,194,BUXAR,2481,58,2,2541,23-04-2022
BIHAR,195,DARBHANGA,7665,157,5,7827,23-04-2022
BIHAR,196,GAYA,8193,164,10,8367,23-04-2022
BIHAR,197,GOPALGANJ,4450,70,1,4521,23-04-2022
BIHAR,198,JAMUI,3795,69,0,3864,23-04-2022
BIHAR,199,JEHANABAD,1637,18,0,1655,23-04-2022
BIHAR,200,KAIMUR (BHABUA),1792,40,1,1833,23-04-2022
BIHAR,201,KATIHAR,5850,153,5,6008,23-04-2022
BIHAR,202,KHAGARIA,3543,74,2,3619,23-04-2022
BIHAR,203,KISHANGANJ,2662,56,4,2722,23-04-2022
BIHAR,204,LAKHISARAI,1766,29,0,1795,23-04-2022
BIHAR,205,MADHEPURA,3303,77,3,3383,23-04-2022
BIHAR,206,MADHUBANI,8151,107,1,8259,23-04-2022
BIHAR,207,MUNGER,3182,27,0,3209,23-04-2022
BIHAR,208,MUZAFFARPUR,14291,424,21,14736,23-04-2022
BIHAR,209,NALANDA,5167,107,2,5276,23-04-2022
BIHAR,210,NAWADA,3564,69,2,3635,23-04-2022
BIHAR,211,PASHCHIM  CHAMPARAN,6046,129,1,6176,23-04-2022
BIHAR,212,PATNA,31118,1158,110,32386,23-04-2022
BIHAR,213,PURBI  CHAMPARAN,10509,195,5,10709,23-04-2022
BIHAR,214,PURNIA,8523,311,29,8863,23-04-2022
BIHAR,215,ROHTAS,4992,113,4,5109,23-04-2022
BIHAR,216,SAHARSA,3509,82,3,3594,23-04-2022
BIHAR,217,SAMASTIPUR,9409,178,6,9593,23-04-2022
BIHAR,218,SARAN,6370,109,2,6481,23-04-2022
BIHAR,219,SHEIKHPURA,1383,21,0,1404,23-04-2022
BIHAR,220,SHEOHAR,1389,12,0,1401,23-04-2022
BIHAR,221,SITAMARHI,6067,102,3,6172,23-04-2022
BIHAR,222,SIWAN,5214,100,3,5317,23-04-2022
BIHAR,223,SUPAUL,3775,60,4,3839,23-04-2022
BIHAR,224,VAISHALI,8356,125,4,8485,23-04-2022
CHHATTISGARH,646,BALOD,1650,35,3,1688,23-04-2022
CHHATTISGARH,644,BALOD BAZAR,3282,64,1,3347,23-04-2022
CHHATTISGARH,649,BALRAMPUR,980,8,1,989,23-04-2022
CHHATTISGARH,374,BASTAR,1682,56,3,1741,23-04-2022
CHHATTISGARH,650,BEMETARA,1773,25,0,1798,23-04-2022
CHHATTISGARH,636,BIJAPUR,199,1,0,200,23-04-2022
CHHATTISGARH,375,BILASPUR,7664,329,20,8013,23-04-2022
CHHATTISGARH,376,DANTEWADA,424,13,0,437,23-04-2022
CHHATTISGARH,377,DHAMTARI,1934,55,0,1989,23-04-2022
CHHATTISGARH,378,DURG,9190,367,34,9591,23-04-2022
CHHATTISGARH,645,GARIABAND,910,10,0,920,23-04-2022
CHHATTISGARH,734,Gaurella Pendra Marwahi,262,3,0,265,23-04-2022
CHHATTISGARH,379,JANJGIR-CHAMPA,3816,89,2,3907,23-04-2022
CHHATTISGARH,380,JASHPUR,893,37,2,932,23-04-2022
CHHATTISGARH,382,KABIRDHAM,1549,42,2,1593,23-04-2022
CHHATTISGARH,381,KANKER,1670,34,2,1706,23-04-2022
CHHATTISGARH,643,KONDAGAON,858,20,0,878,23-04-2022
CHHATTISGARH,383,KORBA,4526,196,31,4753,23-04-2022
CHHATTISGARH,384,KOREA,1628,34,0,1662,23-04-2022
CHHATTISGARH,385,MAHASAMUND,2620,50,1,2671,23-04-2022
CHHATTISGARH,647,MUNGELI,1130,13,0,1143,23-04-2022
CHHATTISGARH,637,NARAYANPUR,179,2,0,181,23-04-2022
CHHATTISGARH,386,RAIGARH,4508,230,19,4757,23-04-2022
CHHATTISGARH,387,RAIPUR,17851,1292,140,19283,23-04-2022
CHHATTISGARH,388,RAJNANDAGAON,4088,109,3,4200,23-04-2022
CHHATTISGARH,642,SUKMA,204,6,0,210,23-04-2022
CHHATTISGARH,648,SURAJPUR,1674,37,0,1711,23-04-2022
CHHATTISGARH,389,SURGUJA,2520,113,8,2641,23-04-2022
GOA,551,NORTH GOA,6369,287,26,6682,23-04-2022
GOA,552,SOUTH GOA,4735,215,15,4965,23-04-2022
GUJARAT,438,AHMADABAD,85650,3666,460,89776,23-04-2022
GUJARAT,439,AMRELI,3191,123,2,3316,23-04-2022
GUJARAT,440,ANAND,8521,187,9,8717,23-04-2022
GUJARAT,672,ARVALLI,2222,73,1,2296,23-04-2022
GUJARAT,441,BANAS KANTHA,7843,301,21,8165,23-04-2022
GUJARAT,442,BHARUCH,10142,485,24,10651,23-04-2022
GUJARAT,443,BHAVNAGAR,10739,284,25,11048,23-04-2022
GUJARAT,676,BOTAD,1222,37,2,1261,23-04-2022
GUJARAT,668,CHHOTAUDEPUR,1221,21,1,1243,23-04-2022
GUJARAT,444,DANG,209,5,0,214,23-04-2022
GUJARAT,674,DEVBHOOMI DWARKA,2288,80,3,2371,23-04-2022
GUJARAT,445,DOHAD,2329,62,8,2399,23-04-2022
GUJARAT,446,GANDHINAGAR,8855,270,18,9143,23-04-2022
GUJARAT,675,GIR SOMNATH,2873,117,2,2992,23-04-2022
GUJARAT,447,JAMNAGAR,8721,397,26,9144,23-04-2022
GUJARAT,448,JUNAGADH,6996,195,8,7199,23-04-2022
GUJARAT,449,KACHCHH,17245,1162,129,18536,23-04-2022
GUJARAT,450,KHEDA,5537,104,3,5644,23-04-2022
GUJARAT,451,MAHESANA,7399,397,28,7824,23-04-2022
GUJARAT,669,MAHISAGAR,912,16,0,928,23-04-2022
GUJARAT,673,MORBI,6327,314,13,6654,23-04-2022
GUJARAT,452,NARMADA,745,20,0,765,23-04-2022
GUJARAT,453,NAVSARI,4960,131,3,5094,23-04-2022
GUJARAT,454,PANCH MAHALS,3203,74,5,3282,23-04-2022
GUJARAT,455,PATAN,2623,102,3,2728,23-04-2022
GUJARAT,456,PORBANDAR,3006,115,5,3126,23-04-2022
GUJARAT,457,RAJKOT,31750,1030,114,32894,23-04-2022
GUJARAT,458,SABAR KANTHA,5561,148,10,5719,23-04-2022
GUJARAT,459,SURAT,55224,1990,181,57395,23-04-2022
GUJARAT,460,SURENDRANAGAR,4343,144,7,4494,23-04-2022
GUJARAT,641,TAPI,1362,40,2,1404,23-04-2022
GUJARAT,461,VADODARA,37847,1236,119,39202,23-04-2022
GUJARAT,462,VALSAD,13935,494,24,14453,23-04-2022
HARYANA,58,AMBALA,8338,342,15,8695,23-04-2022
HARYANA,59,BHIWANI,7160,212,6,7378,23-04-2022
HARYANA,701,CHARKI DADRI,762,25,0,787,23-04-2022
HARYANA,60,FARIDABAD,21229,1004,81,22314,23-04-2022
HARYANA,61,FATEHABAD,5330,159,5,5494,23-04-2022
HARYANA,62,GURUGRAM,26889,2046,268,29203,23-04-2022
HARYANA,63,HISAR,12874,471,34,13379,23-04-2022
HARYANA,64,JHAJJAR,5571,197,6,5774,23-04-2022
HARYANA,65,JIND,7246,246,13,7505,23-04-2022
HARYANA,66,KAITHAL,7242,160,5,7407,23-04-2022
HARYANA,67,KARNAL,13500,418,23,13941,23-04-2022
HARYANA,68,KURUKSHETRA,8173,270,8,8451,23-04-2022
HARYANA,69,MAHENDRAGARH,4153,123,3,4279,23-04-2022
HARYANA,604,NUH,3685,103,5,3793,23-04-2022
HARYANA,619,PALWAL,5031,169,5,5205,23-04-2022
HARYANA,70,PANCHKULA,5734,313,24,6071,23-04-2022
HARYANA,71,PANIPAT,10621,544,40,11205,23-04-2022
HARYANA,72,REWARI,6068,309,23,6400,23-04-2022
HARYANA,73,ROHTAK,6450,313,23,6786,23-04-2022
HARYANA,74,SIRSA,7935,266,15,8216,23-04-2022
HARYANA,75,SONIPAT,8705,313,16,9034,23-04-2022
HARYANA,76,YAMUNANAGAR,8811,304,11,9126,23-04-2022
HIMACHAL PRADESH,15,BILASPUR,1286,37,2,1325,23-04-2022
HIMACHAL PRADESH,16,CHAMBA,1349,25,NA,1374,23-04-2022
HIMACHAL PRADESH,17,HAMIRPUR,1789,40,1,1830,23-04-2022
HIMACHAL PRADESH,18,KANGRA,5406,152,2,5560,23-04-2022
HIMACHAL PRADESH,19,KINNAUR,270,2,NA,272,23-04-2022
HIMACHAL PRADESH,20,KULLU,2451,66,1,2518,23-04-2022
HIMACHAL PRADESH,21,LAHUL AND SPITI,183,NA,NA,183,23-04-2022
HIMACHAL PRADESH,22,MANDI,3575,91,3,3669,23-04-2022
HIMACHAL PRADESH,23,SHIMLA,3884,127,8,4019,23-04-2022
HIMACHAL PRADESH,24,SIRMAUR,1978,47,2,2027,23-04-2022
HIMACHAL PRADESH,25,SOLAN,6109,229,15,6353,23-04-2022
HIMACHAL PRADESH,26,UNA,2199,50,2,2251,23-04-2022
JHARKHAND,322,BOKARO ,9258,229,14,9501,23-04-2022
JHARKHAND,323,CHATRA,1977,26,1,2004,23-04-2022
JHARKHAND,324,DEOGHAR,3453,102,8,3563,23-04-2022
JHARKHAND,325,DHANBAD,11706,301,22,12029,23-04-2022
JHARKHAND,326,DUMKA,2018,53,7,2078,23-04-2022
JHARKHAND,327,EAST SINGHBHUM,11791,521,36,12348,23-04-2022
JHARKHAND,328,GARHWA ,1413,36,NA,1449,23-04-2022
JHARKHAND,329,GIRIDIH,6364,73,5,6442,23-04-2022
JHARKHAND,330,GODDA,1981,35,2,2018,23-04-2022
JHARKHAND,331,GUMLA ,1116,37,NA,1153,23-04-2022
JHARKHAND,332,HAZARIBAG ,7124,110,8,7242,23-04-2022
JHARKHAND,333,JAMTARA,1023,11,NA,1034,23-04-2022
JHARKHAND,606,KHUNTI ,604,11,NA,615,23-04-2022
JHARKHAND,334,KODERMA ,2737,50,2,2789,23-04-2022
JHARKHAND,335,LATEHAR,1022,24,1,1047,23-04-2022
JHARKHAND,336,LOHARDAGA ,1033,28,NA,1061,23-04-2022
JHARKHAND,337,PAKUR ,1328,21,NA,1349,23-04-2022
JHARKHAND,338,PALAMU,2412,57,3,2472,23-04-2022
JHARKHAND,607,RAMGARH ,4228,113,3,4344,23-04-2022
JHARKHAND,339,RANCHI ,17215,707,58,17980,23-04-2022
JHARKHAND,340,SAHEBGANJ,1620,36,1,1657,23-04-2022
JHARKHAND,341,SERAIKELA-KHARSAWAN  ,2930,100,9,3039,23-04-2022
JHARKHAND,342,SIMDEGA ,588,12,NA,600,23-04-2022
JHARKHAND,343,WEST SINGHBHUM,2139,60,2,2201,23-04-2022
KARNATAKA,524,BAGALKOT,7789,138,4,7931,23-04-2022
KARNATAKA,528,BALLARI,9842,362,29,10233,23-04-2022
KARNATAKA,527,BELAGAVI,22266,406,21,22693,23-04-2022
KARNATAKA,526,BENGALURU (RURAL),17583,455,37,18075,23-04-2022
KARNATAKA,525,BENGALURU (URBAN),98320,5951,754,105025,23-04-2022
KARNATAKA,529,BIDAR,5226,108,2,5336,23-04-2022
KARNATAKA,531,CHAMARAJNAGAR,2618,69,2,2689,23-04-2022
KARNATAKA,630,CHIKBALLAPUR,4013,121,7,4141,23-04-2022
KARNATAKA,532,CHIKKAMAGALURU,4528,133,5,4666,23-04-2022
KARNATAKA,533,CHITRADURGA,4782,136,5,4923,23-04-2022
KARNATAKA,534,DAKSHIN KANNAD,14530,531,38,15099,23-04-2022
KARNATAKA,535,DAVANGERE,7264,228,7,7499,23-04-2022
KARNATAKA,536,DHARWAD,15170,462,34,15666,23-04-2022
KARNATAKA,537,GADAG,4256,93,2,4351,23-04-2022
KARNATAKA,539,HASSAN,7330,260,2,7592,23-04-2022
KARNATAKA,540,HAVERI,5537,170,3,5710,23-04-2022
KARNATAKA,538,KALABURAGI,6720,223,16,6959,23-04-2022
KARNATAKA,541,KODAGU,2938,76,3,3017,23-04-2022
KARNATAKA,542,KOLAR,5304,175,6,5485,23-04-2022
KARNATAKA,543,KOPPAL,4070,163,2,4235,23-04-2022
KARNATAKA,544,MANDYA,6517,148,2,6667,23-04-2022
KARNATAKA,545,MYSURU,16974,586,29,17589,23-04-2022
KARNATAKA,546,RAICHUR,6160,281,6,6447,23-04-2022
KARNATAKA,631,RAMANAGARA,4292,103,5,4400,23-04-2022
KARNATAKA,547,SHIVAMOGGA,8400,291,17,8708,23-04-2022
KARNATAKA,548,TUMAKURU,9561,264,12,9837,23-04-2022
KARNATAKA,549,UDUPI,7309,226,13,7548,23-04-2022
KARNATAKA,550,UTTAR KANNAD,6966,112,4,7082,23-04-2022
KARNATAKA,738,VIJAYANAGAR,283,11,NA,294,23-04-2022
KARNATAKA,530,VIJAYAPURA,8889,231,15,9135,23-04-2022
KARNATAKA,635,YADGIR,4472,77,1,4550,23-04-2022
KERALA,554,ALAPPUZHA,7652,300,7,7959,23-04-2022
KERALA,555,ERNAKULAM,20131,1623,142,21896,23-04-2022
KERALA,556,IDUKKI,3370,190,7,3567,23-04-2022
KERALA,557,KANNUR,8469,323,28,8820,23-04-2022
KERALA,558,KASARAGOD,3545,136,3,3684,23-04-2022
KERALA,559,KOLLAM,7717,438,13,8168,23-04-2022
KERALA,560,KOTTAYAM,7466,429,27,7922,23-04-2022
KERALA,561,KOZHIKODE,10964,527,39,11530,23-04-2022
KERALA,562,MALAPPURAM,9053,395,24,9472,23-04-2022
KERALA,563,PALAKKAD,9025,343,20,9388,23-04-2022
KERALA,564,PATHANAMTHIPTA,4258,210,9,4477,23-04-2022
KERALA,565,THIRUVANANTHAPURAM,18152,678,54,18884,23-04-2022
KERALA,566,THRISSUR,12299,640,49,12988,23-04-2022
KERALA,567,WAYANAD,2962,98,5,3065,23-04-2022
MADHYA PRADESH,667,AGAR MALWA,2258,44,1,2303,23-04-2022
MADHYA PRADESH,639,ALIRAJPUR,743,18,NA,761,23-04-2022
MADHYA PRADESH,390,ANUPPUR,1596,19,1,1616,23-04-2022
MADHYA PRADESH,391,ASHOKNAGAR,1941,56,4,2001,23-04-2022
MADHYA PRADESH,392,BALAGHAT,6463,81,2,6546,23-04-2022
MADHYA PRADESH,393,BARWANI,3151,92,1,3244,23-04-2022
MADHYA PRADESH,394,BETUL,5205,90,2,5297,23-04-2022
MADHYA PRADESH,395,BHIND,2757,46,1,2804,23-04-2022
MADHYA PRADESH,396,BHOPAL,19056,798,63,19917,23-04-2022
MADHYA PRADESH,397,BURHANPUR,2209,35,NA,2244,23-04-2022
MADHYA PRADESH,398,CHHATARPUR,3374,105,2,3481,23-04-2022
MADHYA PRADESH,399,CHHINDWARA,8325,206,10,8541,23-04-2022
MADHYA PRADESH,400,DAMOH,2549,70,2,2621,23-04-2022
MADHYA PRADESH,401,DATIA,1348,38,NA,1386,23-04-2022
MADHYA PRADESH,402,DEWAS,7114,141,2,7257,23-04-2022
MADHYA PRADESH,403,DHAR,7320,203,5,7528,23-04-2022
MADHYA PRADESH,404,DINDORI,1280,10,NA,1290,23-04-2022
MADHYA PRADESH,405,EAST NIMAR,3332,94,5,3431,23-04-2022
MADHYA PRADESH,406,GUNA,4553,109,5,4667,23-04-2022
MADHYA PRADESH,407,GWALIOR,13606,528,31,14165,23-04-2022
MADHYA PRADESH,408,HARDA,1957,64,1,2022,23-04-2022
MADHYA PRADESH,409,HOSHANGABAD,3736,136,12,3884,23-04-2022
MADHYA PRADESH,410,INDORE,30286,1700,147,32133,23-04-2022
MADHYA PRADESH,411,JABALPUR,12439,453,33,12925,23-04-2022
MADHYA PRADESH,412,JHABUA,1815,43,1,1859,23-04-2022
MADHYA PRADESH,413,KATNI,4180,154,11,4345,23-04-2022
MADHYA PRADESH,414,KHARGONE,5654,153,3,5810,23-04-2022
MADHYA PRADESH,415,MANDLA,2689,32,0,2721,23-04-2022
MADHYA PRADESH,416,MANDSAUR,7690,158,6,7854,23-04-2022
MADHYA PRADESH,417,MORENA,3935,104,3,4042,23-04-2022
MADHYA PRADESH,418,NARSINGHPUR,3094,110,1,3205,23-04-2022
MADHYA PRADESH,419,NEEMUCH,4513,98,3,4614,23-04-2022
MADHYA PRADESH,722,NIWARI,263,11,0,274,23-04-2022
MADHYA PRADESH,420,PANNA,2165,23,0,2188,23-04-2022
MADHYA PRADESH,421,RAISEN,4269,129,1,4399,23-04-2022
MADHYA PRADESH,422,RAJGARH,6849,119,0,6968,23-04-2022
MADHYA PRADESH,423,RATLAM,6409,181,5,6595,23-04-2022
MADHYA PRADESH,424,REWA,8100,137,8,8245,23-04-2022
MADHYA PRADESH,425,SAGAR,6259,174,9,6442,23-04-2022
MADHYA PRADESH,426,SATNA,6848,210,12,7070,23-04-2022
MADHYA PRADESH,427,SEHORE,6411,124,3,6538,23-04-2022
MADHYA PRADESH,428,SEONI,4115,108,5,4228,23-04-2022
MADHYA PRADESH,429,SHAHDOL,2954,76,1,3031,23-04-2022
MADHYA PRADESH,430,SHAJAPUR,4599,98,1,4698,23-04-2022
MADHYA PRADESH,431,SHEOPUR,690,33,0,723,23-04-2022
MADHYA PRADESH,432,SHIVPURI,3062,104,2,3168,23-04-2022
MADHYA PRADESH,433,SIDHI,1998,40,2,2040,23-04-2022
MADHYA PRADESH,638,SINGRAULI,3005,81,5,3091,23-04-2022
MADHYA PRADESH,434,TIKAMGARH,1693,47,0,1740,23-04-2022
MADHYA PRADESH,435,UJJAIN,10384,282,9,10675,23-04-2022
MADHYA PRADESH,436,UMARIA,995,19,0,1014,23-04-2022
MADHYA PRADESH,437,VIDISHA,4735,148,1,4884,23-04-2022
MAHARASHTRA,466,AHMEDNAGAR,43128,656,24,43808,23-04-2022
MAHARASHTRA,467,AKOLA,12001,202,12,12215,23-04-2022
MAHARASHTRA,468,AMRAVATI,17180,286,12,17478,23-04-2022
MAHARASHTRA,469,AURANGABAD,52606,758,59,53423,23-04-2022
MAHARASHTRA,470,BEED,15144,201,5,15350,23-04-2022
MAHARASHTRA,471,BHANDARA,7370,79,2,7451,23-04-2022
MAHARASHTRA,472,BULDHANA,15605,236,9,15850,23-04-2022
MAHARASHTRA,473,CHANDRAPUR,10648,267,14,10929,23-04-2022
MAHARASHTRA,474,DHULE,9845,214,16,10075,23-04-2022
MAHARASHTRA,475,GADCHIROLI,4186,67,1,4254,23-04-2022
MAHARASHTRA,476,GONDIA,7740,122,6,7868,23-04-2022
MAHARASHTRA,477,HINGOLI,5925,99,3,6027,23-04-2022
MAHARASHTRA,478,JALGAON,27917,507,24,28448,23-04-2022
MAHARASHTRA,479,JALNA,17086,224,21,17331,23-04-2022
MAHARASHTRA,480,KOLHAPUR,40895,665,67,41627,23-04-2022
MAHARASHTRA,481,LATUR,14925,295,11,15231,23-04-2022
MAHARASHTRA,482,MUMBAI ,84729,5921,1000,91650,23-04-2022
MAHARASHTRA,483,MUMBAI SUBURBAN,103299,3879,550,107728,23-04-2022
MAHARASHTRA,484,NAGPUR,53438,1652,168,55258,23-04-2022
MAHARASHTRA,485,NAN DED,16748,291,16,17055,23-04-2022
MAHARASHTRA,486,NANDURBAR,4770,97,7,4874,23-04-2022
MAHARASHTRA,487,NASHIK,57198,1235,84,58517,23-04-2022
MAHARASHTRA,488,OSMANABAD,12285,104,1,12390,23-04-2022
MAHARASHTRA,665,PALGHAR,38669,396,27,39092,23-04-2022
MAHARASHTRA,489,PARBHANI,11322,141,5,11468,23-04-2022
MAHARASHTRA,490,PUNE,178247,4366,407,183020,23-04-2022
MAHARASHTRA,491,RAIGAD,47146,870,60,48076,23-04-2022
MAHARASHTRA,492,RATNAGIRI,14979,128,6,15113,23-04-2022
MAHARASHTRA,493,SANGLI,25927,451,19,26397,23-04-2022
MAHARASHTRA,494,SATARA,29405,341,16,29762,23-04-2022
MAHARASHTRA,495,SINDHUDURG,6993,59,1,7053,23-04-2022
MAHARASHTRA,496,SOLAPUR,40243,554,31,40828,23-04-2022
MAHARASHTRA,497,THANE,143259,3321,336,146916,23-04-2022
MAHARASHTRA,498,WARDHA,9929,109,7,10045,23-04-2022
MAHARASHTRA,499,WASHIM,6384,111,8,6503,23-04-2022
MAHARASHTRA,500,YAVATMAL,12044,195,10,12249,23-04-2022
MANIPUR,252,BISHNUPUR,1104,11,0,1115,23-04-2022
MANIPUR,253,CHANDEL,275,0,1,276,23-04-2022
MANIPUR,254,CHURACHANDPUR,610,7,0,617,23-04-2022
MANIPUR,255,IMPHAL EAST,2945,43,1,2989,23-04-2022
MANIPUR,256,IMPHAL WEST,4067,121,8,4196,23-04-2022
MANIPUR,713,JIRIBAM,31,0,0,31,23-04-2022
MANIPUR,711,KAKCHING,210,4,0,214,23-04-2022
MANIPUR,717,KAMJONG,25,0,0,25,23-04-2022
MANIPUR,712,KANGPOKPI,90,0,0,90,23-04-2022
MANIPUR,714,NONEY,18,0,0,18,23-04-2022
MANIPUR,715,PHERZAWL,1,0,0,1,23-04-2022
MANIPUR,257,SENAPATI,571,6,0,577,23-04-2022
MANIPUR,258,TAMENGLONG,159,0,0,159,23-04-2022
MANIPUR,716,TENGNOUPAL,39,0,0,39,23-04-2022
MANIPUR,259,THOUBAL,1567,14,0,1581,23-04-2022
MANIPUR,260,UKHRUL,291,1,0,292,23-04-2022
MEGHALAYA,273,EAST GARO HILLS,65,0,0,65,23-04-2022
MEGHALAYA,657,EAST JAINTIA HILLS,76,6,0,82,23-04-2022
MEGHALAYA,274,EAST KHASI HILLS,865,104,8,977,23-04-2022
MEGHALAYA,740,EASTERN WEST KHASI HILLS,1,0,0,1,23-04-2022
MEGHALAYA,656,NORTH GARO HILLS,31,0,0,31,23-04-2022
MEGHALAYA,276,RI BHOI,192,5,4,201,23-04-2022
MEGHALAYA,277,SOUTH GARO HILLS,55,2,0,57,23-04-2022
MEGHALAYA,663,SOUTH WEST  GARO HILLS,143,1,0,144,23-04-2022
MEGHALAYA,658,SOUTH WEST KHASI HILLS,34,1,0,35,23-04-2022
MEGHALAYA,278,WEST GARO HILLS,452,8,2,462,23-04-2022
MEGHALAYA,275,WEST JAINTIA HILLS,136,1,0,137,23-04-2022
MEGHALAYA,279,WEST KHASI HILLS,66,1,0,67,23-04-2022
MIZORAM,261,AIZAWL,1583,64,8,1655,23-04-2022
MIZORAM,262,CHAMPHAI,296,3,0,299,23-04-2022
MIZORAM,726,Hnahthial,21,0,0,21,23-04-2022
MIZORAM,728,Khawzawl,63,1,0,64,23-04-2022
MIZORAM,263,KOLASIB,419,1,0,420,23-04-2022
MIZORAM,264,LAWNGTLAI,124,0,0,124,23-04-2022
MIZORAM,265,LUNGLEI,402,3,0,405,23-04-2022
MIZORAM,266,MAMIT,152,0,0,152,23-04-2022
MIZORAM,267,SAIHA,67,4,0,71,23-04-2022
MIZORAM,727,Saitual,40,0,0,40,23-04-2022
MIZORAM,268,SERCHHIP,178,2,0,180,23-04-2022
NAGALAND,244,DIMAPUR,1234,31,7,1272,23-04-2022
NAGALAND,614,KIPHRIE,37,0,0,37,23-04-2022
NAGALAND,245,KOHIMA,583,13,0,596,23-04-2022
NAGALAND,615,LONGLENG,8,0,0,8,23-04-2022
NAGALAND,246,MOKOKCHUNG,216,0,0,216,23-04-2022
NAGALAND,247,MON,121,0,0,121,23-04-2022
NAGALAND,736,Noklak,2,0,0,2,23-04-2022
NAGALAND,613,PEREN,113,0,0,113,23-04-2022
NAGALAND,248,PHEK,64,0,0,64,23-04-2022
NAGALAND,249,TUENSANG,17,0,0,17,23-04-2022
NAGALAND,250,WOKHA,99,1,0,100,23-04-2022
NAGALAND,251,ZUNHEBOTO,60,0,0,60,23-04-2022
ODISHA,344,ANGUL,4132,219,21,4372,23-04-2022
ODISHA,345,BALANGIR,3027,82,5,3114,23-04-2022
ODISHA,346,BALESHWAR,5286,188,10,5484,23-04-2022
ODISHA,347,BARGARH,2996,118,6,3120,23-04-2022
ODISHA,348,BHADRAK,3224,71,2,3297,23-04-2022
ODISHA,349,BOUDH,854,9,0,863,23-04-2022
ODISHA,350,CUTTACK,11813,499,47,12359,23-04-2022
ODISHA,351,DEOGARH,511,8,0,519,23-04-2022
ODISHA,352,DHENKANAL,2797,65,1,2863,23-04-2022
ODISHA,353,GAJAPATI,812,20,1,833,23-04-2022
ODISHA,354,GANJAM,10018,308,8,10334,23-04-2022
ODISHA,355,JAGATSINGHPUR,4443,121,5,4569,23-04-2022
ODISHA,356,JAJAPUR,5270,206,11,5487,23-04-2022
ODISHA,357,JHARSUGUDA,2506,144,7,2657,23-04-2022
ODISHA,358,KALAHANDI,2557,91,5,2653,23-04-2022
ODISHA,359,KANDHAMAL,1313,10,0,1323,23-04-2022
ODISHA,360,KENDRAPARA,3355,72,1,3428,23-04-2022
ODISHA,361,KENDUJHAR,6126,227,24,6377,23-04-2022
ODISHA,362,KHORDHA,16662,939,92,17693,23-04-2022
ODISHA,363,KORAPUT,2393,84,3,2480,23-04-2022
ODISHA,364,MALKANGIRI  ,1072,30,0,1102,23-04-2022
ODISHA,365,MAYURBHANJ,3637,115,1,3753,23-04-2022
ODISHA,366,NABARANGPUR,1146,50,1,1197,23-04-2022
ODISHA,367,NAYAGARH,2471,35,0,2506,23-04-2022
ODISHA,368,NUAPADA,982,22,0,1004,23-04-2022
ODISHA,369,PURI,5365,77,2,5444,23-04-2022
ODISHA,370,RAYAGADA,2009,51,1,2061,23-04-2022
ODISHA,371,SAMBALPUR,3130,177,12,3319,23-04-2022
ODISHA,372,SONEPUR,1207,16,1,1224,23-04-2022
ODISHA,373,SUNDARGARH,6347,409,40,6796,23-04-2022
PUNJAB,27,AMRITSAR,14542,550,39,15131,23-04-2022
PUNJAB,605,BARNALA,3525,106,2,3633,23-04-2022
PUNJAB,28,BATHINDA,9941,417,22,10380,23-04-2022
PUNJAB,29,FARIDKOT,4187,101,2,4290,23-04-2022
PUNJAB,30,FATEHGARH SAHIB,4061,366,33,4460,23-04-2022
PUNJAB,651,FAZILKA,5301,145,10,5456,23-04-2022
PUNJAB,31,FIROZEPUR,5246,116,3,5365,23-04-2022
PUNJAB,32,GURDASPUR,5535,131,8,5674,23-04-2022
PUNJAB,33,HOSHIARPUR,8774,195,8,8977,23-04-2022
PUNJAB,34,JALANDHAR,20011,601,49,20661,23-04-2022
PUNJAB,35,KAPURTHALA,6194,143,8,6345,23-04-2022
PUNJAB,36,LUDHIANA,31257,1464,96,32817,23-04-2022
PUNJAB,737,MALERKOTLA,292,6,0,298,23-04-2022
PUNJAB,37,MANSA,3620,83,1,3704,23-04-2022
PUNJAB,38,MOGA,6375,145,5,6525,23-04-2022
PUNJAB,662,PATHANKOT,3144,100,2,3246,23-04-2022
PUNJAB,41,PATIALA,15569,401,15,15985,23-04-2022
PUNJAB,42,RUPNAGAR,4008,109,6,4123,23-04-2022
PUNJAB,43,SANGRUR,8549,243,5,8797,23-04-2022
PUNJAB,608,SAS NAGAR,18101,515,47,18663,23-04-2022
PUNJAB,40,SHAHID BHAGAT SINGH NAGAR,4014,79,0,4093,23-04-2022
PUNJAB,39,SRI MUKTSAR SAHIB,4852,148,4,5004,23-04-2022
PUNJAB,609,TARN TARAN,3304,52,0,3356,23-04-2022
RAJASTHAN,86,AJMER,21717,481,38,22236,23-04-2022
RAJASTHAN,87,ALWAR,19791,540,27,20358,23-04-2022
RAJASTHAN,88,BANSWARA,4494,86,3,4583,23-04-2022
RAJASTHAN,89,BARAN,3915,149,10,4074,23-04-2022
RAJASTHAN,90,BARMER,10453,271,8,10732,23-04-2022
RAJASTHAN,91,BHARATPUR,5995,180,7,6182,23-04-2022
RAJASTHAN,92,BHILWARA,17598,399,25,18022,23-04-2022
RAJASTHAN,93,BIKANER,19388,527,22,19937,23-04-2022
RAJASTHAN,94,BUNDI,5022,85,3,5110,23-04-2022
RAJASTHAN,95,CHITTORGARH,10048,264,12,10324,23-04-2022
RAJASTHAN,96,CHURU,10255,111,2,10368,23-04-2022
RAJASTHAN,97,DAUSA,6421,91,2,6514,23-04-2022
RAJASTHAN,98,DHOLPUR,1844,45,1,1890,23-04-2022
RAJASTHAN,99,DUNGARPUR,4466,58,2,4526,23-04-2022
RAJASTHAN,100,GANGANAGAR,16376,481,22,16879,23-04-2022
RAJASTHAN,101,HANUMANGARH,11485,197,10,11692,23-04-2022
RAJASTHAN,102,JAIPUR,87657,2753,265,90675,23-04-2022
RAJASTHAN,103,JAISALMER,2887,62,0,2949,23-04-2022
RAJASTHAN,104,JALORE,5930,106,1,6037,23-04-2022
RAJASTHAN,105,JHALAWAR,5320,129,4,5453,23-04-2022
RAJASTHAN,106,JHUNJHUNU,10846,158,7,11011,23-04-2022
RAJASTHAN,107,JODHPUR,27869,847,55,28771,23-04-2022
RAJASTHAN,108,KARAULI,2910,59,0,2969,23-04-2022
RAJASTHAN,109,KOTA,14245,592,46,14883,23-04-2022
RAJASTHAN,110,NAGAUR,16178,297,15,16490,23-04-2022
RAJASTHAN,111,PALI,11255,209,9,11473,23-04-2022
RAJASTHAN,629,PRATAPGARH,3159,34,0,3193,23-04-2022
RAJASTHAN,112,RAJSAMAND,6286,98,3,6387,23-04-2022
RAJASTHAN,113,SAWAI MADHOPUR,4470,95,1,4566,23-04-2022
RAJASTHAN,114,SIKAR,16834,256,11,17101,23-04-2022
RAJASTHAN,115,SIROHI,5938,78,5,6021,23-04-2022
RAJASTHAN,116,TONK,5719,129,4,5852,23-04-2022
RAJASTHAN,117,UDAIPUR,18896,562,45,19503,23-04-2022
SIKKIM,225,EAST DISTRICT,1060,49,8,1117,23-04-2022
SIKKIM,226,NORTH DISTRICT,71,1,0,72,23-04-2022
SIKKIM,741,Pakyong,0,0,0,0,23-04-2022
SIKKIM,742,Soreng,0,0,0,0,23-04-2022
SIKKIM,227,SOUTH DISTRICT,291,4,0,295,23-04-2022
SIKKIM,228,WEST DISTRICT,233,3,0,236,23-04-2022
TAMIL NADU,610,ARIYALUR,4273,75,2,4350,23-04-2022
TAMIL NADU,730,Chengalpattu,9412,153,4,9569,23-04-2022
TAMIL NADU,568,CHENNAI,85104,4704,542,90350,23-04-2022
TAMIL NADU,569,COIMBATORE,45503,1419,129,47051,23-04-2022
TAMIL NADU,570,CUDDALORE,13429,247,10,13686,23-04-2022
TAMIL NADU,571,DHARMAPURI,9593,158,2,9753,23-04-2022
TAMIL NADU,572,DINDIGUL,14894,304,16,15214,23-04-2022
TAMIL NADU,573,ERODE,17450,551,26,18027,23-04-2022
TAMIL NADU,729,Kallakurichi,2591,45,1,2637,23-04-2022
TAMIL NADU,574,KANCHIPURAM,26097,605,47,26749,23-04-2022
TAMIL NADU,575,KANNIYAKUMARI,15477,305,9,15791,23-04-2022
TAMIL NADU,576,KARUR,5767,169,7,5943,23-04-2022
TAMIL NADU,577,KRISHNAGIRI,12791,398,12,13201,23-04-2022
TAMIL NADU,578,MADURAI,28009,692,44,28745,23-04-2022
TAMIL NADU,735,Mayiladuthurai,2419,36,0,2455,23-04-2022
TAMIL NADU,579,NAGAPATTINAM,6238,83,0,6321,23-04-2022
TAMIL NADU,580,NAMAKKAL,14158,527,41,14726,23-04-2022
TAMIL NADU,581,PERAMBALUR,3001,58,3,3062,23-04-2022
TAMIL NADU,582,PUDUKKOTTAI,9857,141,3,10001,23-04-2022
TAMIL NADU,583,RAMANATHAPURAM,6495,94,5,6594,23-04-2022
TAMIL NADU,731,Ranipet,3075,51,2,3128,23-04-2022
TAMIL NADU,584,SALEM,27881,793,37,28711,23-04-2022
TAMIL NADU,585,SIVAGANGA,8508,113,6,8627,23-04-2022
TAMIL NADU,733,Tenkasi,4333,80,0,4413,23-04-2022
TAMIL NADU,586,THANJAVUR,16454,355,17,16826,23-04-2022
TAMIL NADU,587,THE NILGIRISH,3451,49,5,3505,23-04-2022
TAMIL NADU,588,THENI,9179,169,9,9357,23-04-2022
TAMIL NADU,589,THIRUVALLUR,23825,597,38,24460,23-04-2022
TAMIL NADU,590,THIRUVARUR,7396,111,1,7508,23-04-2022
TAMIL NADU,591,TIRUCHIRAPPALLI,21703,490,29,22222,23-04-2022
TAMIL NADU,592,TIRUNELVELI,15257,299,13,15569,23-04-2022
TAMIL NADU,732,Tirupattu,1895,31,0,1926,23-04-2022
TAMIL NADU,634,TIRUPPUR,18689,644,19,19352,23-04-2022
TAMIL NADU,593,TIRUVANNAMALAI,10931,166,5,11102,23-04-2022
TAMIL NADU,594,TUTICORIN,12384,308,20,12712,23-04-2022
TAMIL NADU,595,VELLORE,13565,371,15,13951,23-04-2022
TAMIL NADU,596,VILLUPURAM,13054,240,8,13302,23-04-2022
TAMIL NADU,597,VIRUDHUNAGAR,12438,256,12,12706,23-04-2022
TELANGANA,501,ADILABAD,2919,72,4,2995,23-04-2022
TELANGANA,690,BHADRADRI KOTHAGUDEM,3152,60,2,3214,23-04-2022
TELANGANA,507,HYDERABAD,39331,3480,493,43304,23-04-2022
TELANGANA,681,Jagitial,3152,46,0,3198,23-04-2022
TELANGANA,689,JANGOAN,1715,26,1,1742,23-04-2022
TELANGANA,687,JAYASHANKAR BHUPALAPALLY,1438,23,2,1463,23-04-2022
TELANGANA,695,JOGULAMBA GADWAL,1256,32,1,1289,23-04-2022
TELANGANA,685,KAMAREDDY,3092,65,0,3157,23-04-2022
TELANGANA,508,KARIMNAGAR,8574,225,10,8809,23-04-2022
TELANGANA,509,KHAMMAM,5966,217,4,6187,23-04-2022
TELANGANA,699,KOMARAM BHEEM ASIFABAD,801,21,0,822,23-04-2022
TELANGANA,688,MAHABUBABAD,2717,35,1,2753,23-04-2022
TELANGANA,512,MAHABUBNAGAR,6640,120,9,6769,23-04-2022
TELANGANA,684,MANCHERIAL,3073,68,2,3143,23-04-2022
TELANGANA,513,MEDAK,3485,63,2,3550,23-04-2022
TELANGANA,700,MEDCHAL MALKAJGIRI,16892,764,63,17719,23-04-2022
TELANGANA,720,Mulugu,587,8,0,595,23-04-2022
TELANGANA,694,NAGARKURNOOL,2591,36,0,2627,23-04-2022
TELANGANA,514,NALGONDA,10596,149,8,10753,23-04-2022
TELANGANA,721,Narayanpet,714,14,0,728,23-04-2022
TELANGANA,680,Nirmal,1586,41,2,1629,23-04-2022
TELANGANA,516,NIZAMABAD,9071,189,3,9263,23-04-2022
TELANGANA,682,PEDDAPALLI,4046,75,2,4123,23-04-2022
TELANGANA,683,RAJANNA SIRCILLA,1998,26,1,2025,23-04-2022
TELANGANA,518,RANGA REDDI,24067,1084,124,25275,23-04-2022
TELANGANA,691,SANGAREDDY,5293,135,3,5431,23-04-2022
TELANGANA,692,SIDDIPET,3290,71,5,3366,23-04-2022
TELANGANA,696,SURYAPET,5920,118,3,6041,23-04-2022
TELANGANA,698,VIKARABAD,2574,41,0,2615,23-04-2022
TELANGANA,693,WANAPARTHY,1713,27,0,1740,23-04-2022
TELANGANA,522,WARANGAL RURAL,3258,61,1,3320,23-04-2022
TELANGANA,686,WARANGAL URBAN,7423,311,16,7750,23-04-2022
TELANGANA,697,YADADRI BHUVANAGIRI,3289,37,0,3326,23-04-2022
TRIPURA,269,DHALAI,335,4,1,340,23-04-2022
TRIPURA,654,GOMATI,529,13,0,542,23-04-2022
TRIPURA,652,KHOWAI,260,3,0,263,23-04-2022
TRIPURA,270,NORTH TRIPURA,687,21,0,708,23-04-2022
TRIPURA,653,SEPAHIJALA,409,10,0,419,23-04-2022
TRIPURA,271,SOUTH TRIPURA,449,13,0,462,23-04-2022
TRIPURA,655,UNAKOTI,389,7,0,396,23-04-2022
TRIPURA,272,WEST TRIPURA,2273,147,11,2431,23-04-2022
UTTAR PRADESH,118,AGRA,18297,721,56,19074,23-04-2022
UTTAR PRADESH,119,ALIGARH,7462,264,15,7741,23-04-2022
UTTAR PRADESH,121,AMBEDAKAR NAGAR,2977,85,3,3065,23-04-2022
UTTAR PRADESH,640,AMETHI,2874,52,0,2926,23-04-2022
UTTAR PRADESH,154,AMROHA,2513,92,3,2608,23-04-2022
UTTAR PRADESH,122,AURAIYA,1798,68,0,1866,23-04-2022
UTTAR PRADESH,123,AZAMGARH,7246,99,5,7350,23-04-2022
UTTAR PRADESH,124,BAGHPAT,3462,39,0,3501,23-04-2022
UTTAR PRADESH,125,BAHRAICH,2916,149,2,3067,23-04-2022
UTTAR PRADESH,126,BALLIA,3962,100,2,4064,23-04-2022
UTTAR PRADESH,127,BALRAMPUR,1823,55,1,1879,23-04-2022
UTTAR PRADESH,128,BANDA,1882,58,1,1941,23-04-2022
UTTAR PRADESH,129,BARABANKI,4364,140,8,4512,23-04-2022
UTTAR PRADESH,130,BAREILLY,10692,400,39,11131,23-04-2022
UTTAR PRADESH,131,BASTI,3183,101,3,3287,23-04-2022
UTTAR PRADESH,179,BHADOHI,3220,42,2,3264,23-04-2022
UTTAR PRADESH,132,BIJNOR,3711,104,10,3825,23-04-2022
UTTAR PRADESH,133,BUDAUN,2987,103,1,3091,23-04-2022
UTTAR PRADESH,134,BULANDSHAHAR,6117,164,6,6287,23-04-2022
UTTAR PRADESH,135,CHANDAULI,2976,84,5,3065,23-04-2022
UTTAR PRADESH,136,CHITRAKOOT,1376,27,1,1404,23-04-2022
UTTAR PRADESH,137,DEORIA,5576,107,2,5685,23-04-2022
UTTAR PRADESH,138,ETAH,2119,94,5,2218,23-04-2022
UTTAR PRADESH,139,ETAWAH,2353,79,7,2439,23-04-2022
UTTAR PRADESH,140,FAIZABAD,4264,139,7,4410,23-04-2022
UTTAR PRADESH,141,FARRUKHABAD,2243,70,1,2314,23-04-2022
UTTAR PRADESH,142,FATEHPUR,3454,98,3,3555,23-04-2022
UTTAR PRADESH,143,FIROZABAD,4286,92,6,4384,23-04-2022
UTTAR PRADESH,144,GAUTAM BUDDHA NAGAR,24274,1226,130,25630,23-04-2022
UTTAR PRADESH,145,GHAZIABAD,26564,1072,121,27757,23-04-2022
UTTAR PRADESH,146,GHAZIPUR,7006,74,2,7082,23-04-2022
UTTAR PRADESH,147,GONDA,3746,140,5,3891,23-04-2022
UTTAR PRADESH,148,GORAKHAPUR,10216,454,38,10708,23-04-2022
UTTAR PRADESH,149,HAMIRPUR,1507,47,0,1554,23-04-2022
UTTAR PRADESH,661,HAPUR,3974,125,8,4107,23-04-2022
UTTAR PRADESH,150,HARDOI,5036,135,5,5176,23-04-2022
UTTAR PRADESH,163,HATHRAS,3208,87,3,3298,23-04-2022
UTTAR PRADESH,151,JALAUN,1715,70,2,1787,23-04-2022
UTTAR PRADESH,152,JAUNPUR,8284,126,4,8414,23-04-2022
UTTAR PRADESH,153,JHANSI,6038,280,13,6331,23-04-2022
UTTAR PRADESH,155,KANNAUJ,1949,55,0,2004,23-04-2022
UTTAR PRADESH,156,KANPUR DEHAT,2341,56,1,2398,23-04-2022
UTTAR PRADESH,157,KANPUR NAGAR,17353,988,106,18447,23-04-2022
UTTAR PRADESH,633,KASGANJ,1433,48,1,1482,23-04-2022
UTTAR PRADESH,158,KAUSHAMBI,2036,34,0,2070,23-04-2022
UTTAR PRADESH,160,KUSHINAGAR,3872,109,5,3986,23-04-2022
UTTAR PRADESH,159,LAKHIMPUR KHERI,4849,189,10,5048,23-04-2022
UTTAR PRADESH,161,LALITPUR,1588,65,4,1657,23-04-2022
UTTAR PRADESH,162,LUCKNOW,33228,1474,132,34834,23-04-2022
UTTAR PRADESH,164,MAHARAJGANJ,3086,86,3,3175,23-04-2022
UTTAR PRADESH,165,MAHOBA,1282,28,4,1314,23-04-2022
UTTAR PRADESH,166,MAINPURI,2529,75,4,2608,23-04-2022
UTTAR PRADESH,167,MATHURA,10824,241,12,11077,23-04-2022
UTTAR PRADESH,168,MAU,2963,55,2,3020,23-04-2022
UTTAR PRADESH,169,MEERUT,13990,442,23,14455,23-04-2022
UTTAR PRADESH,170,MIRZAPUR,3851,89,4,3944,23-04-2022
UTTAR PRADESH,171,MORADABAD,7708,278,17,8003,23-04-2022
UTTAR PRADESH,172,MUZAFFARNAGAR,7555,272,17,7844,23-04-2022
UTTAR PRADESH,173,PILIBHIT,3181,73,2,3256,23-04-2022
UTTAR PRADESH,174,PRATAPGARH,5275,83,2,5360,23-04-2022
UTTAR PRADESH,120,PRAYAGRAJ,13989,439,29,14457,23-04-2022
UTTAR PRADESH,175,RAE BARELI,4885,94,6,4985,23-04-2022
UTTAR PRADESH,176,RAMPUR,3911,99,2,4012,23-04-2022
UTTAR PRADESH,177,SAHARANPUR,8951,202,11,9164,23-04-2022
UTTAR PRADESH,659,SAMBHAL,2390,74,5,2469,23-04-2022
UTTAR PRADESH,178,SANT KABEER NAGAR,2351,49,3,2403,23-04-2022
UTTAR PRADESH,180,SHAHJAHANPUR,3439,144,11,3594,23-04-2022
UTTAR PRADESH,660,SHAMLI,2275,51,0,2326,23-04-2022
UTTAR PRADESH,181,SHRAVASTI,904,12,0,916,23-04-2022
UTTAR PRADESH,182,SIDDHARTHNAGAR,2239,42,2,2283,23-04-2022
UTTAR PRADESH,183,SITAPUR,4096,177,4,4277,23-04-2022
UTTAR PRADESH,184,SONBHADRA,3675,113,6,3794,23-04-2022
UTTAR PRADESH,185,SULTANPUR,3345,109,2,3456,23-04-2022
UTTAR PRADESH,186,UNNAO,3303,82,1,3386,23-04-2022
UTTAR PRADESH,187,VARANASI,15556,630,63,16249,23-04-2022
UTTARAKHAND,45,ALMORA,2146,14,0,2160,23-04-2022
UTTARAKHAND,46,BAGESHWAR,734,5,1,740,23-04-2022
UTTARAKHAND,47,CHAMOLI,1443,10,0,1453,23-04-2022
UTTARAKHAND,48,CHAMPAWAT,866,15,1,882,23-04-2022
UTTARAKHAND,49,DEHRADUN,17650,549,43,18242,23-04-2022
UTTARAKHAND,50,HARIDWAR,8430,284,11,8725,23-04-2022
UTTARAKHAND,51,NAINITAL,5490,229,15,5734,23-04-2022
UTTARAKHAND,52,PAURI GARHWAL,2160,48,0,2208,23-04-2022
UTTARAKHAND,53,PITHORAGARH,1479,23,0,1502,23-04-2022
UTTARAKHAND,54,RUDRA PRAYAG,1097,6,0,1103,23-04-2022
UTTARAKHAND,55,TEHRI GARHWAL,2232,29,2,2263,23-04-2022
UTTARAKHAND,56,UDHAM SINGH NAGAR,8558,321,13,8892,23-04-2022
UTTARAKHAND,57,UTTARKASHI,1241,5,0,1246,23-04-2022
WEST BENGAL,664,ALIPURDUAR,1604,67,3,1674,23-04-2022
WEST BENGAL,305,BANKURA,3556,135,6,3697,23-04-2022
WEST BENGAL,307,BIRBHUM,3944,147,4,4095,23-04-2022
WEST BENGAL,308,COOCHBEHAR,3174,123,2,3299,23-04-2022
WEST BENGAL,310,DAKSHIN DINAJPUR,1985,80,1,2066,23-04-2022
WEST BENGAL,309,DARJEELING,5819,546,41,6406,23-04-2022
WEST BENGAL,317,EAST MEDINIPUR,9005,408,22,9435,23-04-2022
WEST BENGAL,312,HOOGHLY,8362,372,10,8744,23-04-2022
WEST BENGAL,313,HOWRAH,8896,537,23,9456,23-04-2022
WEST BENGAL,314,JALPAIGURI,4085,183,11,4279,23-04-2022
WEST BENGAL,703,Jhargram,808,25,0,833,23-04-2022
WEST BENGAL,702,KALIMPONG,298,11,0,309,23-04-2022
WEST BENGAL,315,KOLKOTA,23076,3709,532,27317,23-04-2022
WEST BENGAL,316,MALDA,4933,184,12,5129,23-04-2022
WEST BENGAL,319,MURSHIDABAD,8216,294,11,8521,23-04-2022
WEST BENGAL,320,NADIA,6503,207,10,6720,23-04-2022
WEST BENGAL,303,NORTH 24 PRAGANAS,19543,820,57,20420,23-04-2022
WEST BENGAL,704,PASCHIM BARDHAMAN,8160,480,31,8671,23-04-2022
WEST BENGAL,306,PURBA BARDHAMAN,6587,300,6,6893,23-04-2022
WEST BENGAL,321,PURULIA,2226,76,3,2305,23-04-2022
WEST BENGAL,304,SOUTH 24 PRAGANAS,11588,321,24,11933,23-04-2022
WEST BENGAL,311,UTTAR DINAJPUR,3399,199,7,3605,23-04-2022
WEST BENGAL,318,WEST MEDINIPUR,7089,232,13,7334,23-04-2022
ANDAMAN AND NICOBAR ISLANDS,603,NIKOBARS,127,2,0,129,23-04-2022
ANDAMAN AND NICOBAR ISLANDS,632,NORTH AND MIDDLE ANDAMAN,379,6,0,385,23-04-2022
ANDAMAN AND NICOBAR ISLANDS,602,SOUTH ANDAMANS,3062,129,7,3198,23-04-2022
CHANDIGARH,44,CHANDIGARH,11464,789,80,12333,23-04-2022
DADAR AND NAGAR HAVELI,465,DADRA AND NAGAR HAVELLI,3157,111,5,3273,23-04-2022
DAMAN AND DIU,463,DAMAN,1049,38,4,1091,23-04-2022
DAMAN AND DIU,464,DIU,112,8,0,120,23-04-2022
DELHI,77,CENTRAL,8289,1425,179,9893,23-04-2022
DELHI,78,EAST,16175,1070,113,17358,23-04-2022
DELHI,79,NEW DELHI,9837,993,173,11003,23-04-2022
DELHI,80,NORTH,7554,976,123,8653,23-04-2022
DELHI,81,NORTH EAST,8241,344,46,8631,23-04-2022
DELHI,82,NORTH WEST,23697,1665,259,25621,23-04-2022
DELHI,671,SHAHDARA,1717,91,8,1816,23-04-2022
DELHI,83,SOUTH ,19320,1988,279,21587,23-04-2022
DELHI,670,SOUTH EAST,4569,323,40,4932,23-04-2022
DELHI,84,SOUTH WEST,17184,1287,139,18610,23-04-2022
DELHI,85,WEST,18714,1196,155,20065,23-04-2022
JAMMU AND KASHMIR,1,ANANTNAG,9638,112,2,9752,23-04-2022
JAMMU AND KASHMIR,2,BADGAM,4819,49,1,4869,23-04-2022
JAMMU AND KASHMIR,623,BANDIPORA,1487,8,2,1497,23-04-2022
JAMMU AND KASHMIR,3,BARAMULLA,4333,41,2,4376,23-04-2022
JAMMU AND KASHMIR,4,DODA,1983,12,0,1995,23-04-2022
JAMMU AND KASHMIR,626,GANDERBAL,2555,16,2,2573,23-04-2022
JAMMU AND KASHMIR,5,JAMMU,8995,620,34,9649,23-04-2022
JAMMU AND KASHMIR,7,KATHUA,3002,38,2,3042,23-04-2022
JAMMU AND KASHMIR,620,KISHTWAR,2138,12,0,2150,23-04-2022
JAMMU AND KASHMIR,622,KULGAM,2824,21,3,2848,23-04-2022
JAMMU AND KASHMIR,8,KUPWARA,2513,10,0,2523,23-04-2022
JAMMU AND KASHMIR,10,POONCH,2064,20,1,2085,23-04-2022
JAMMU AND KASHMIR,11,PULWAMA,4077,56,9,4142,23-04-2022
JAMMU AND KASHMIR,12,RAJAURI,2750,38,1,2789,23-04-2022
JAMMU AND KASHMIR,621,RAMBAN,1973,15,0,1988,23-04-2022
JAMMU AND KASHMIR,627,REASI,1190,21,0,1211,23-04-2022
JAMMU AND KASHMIR,624,SAMBA,1281,44,2,1327,23-04-2022
JAMMU AND KASHMIR,625,SHOPIAN,1547,12,3,1562,23-04-2022
JAMMU AND KASHMIR,13,SRINAGAR,6833,221,7,7061,23-04-2022
JAMMU AND KASHMIR,14,UDHAMPUR,1642,42,1,1685,23-04-2022
LADAKH,6,KARGIL,703,12,0,715,23-04-2022
LADAKH,9,LEH LADAKH,1469,31,1,1501,23-04-2022
LAKSHADWEEP,553,LAKSHADWEEP DISTRICT,209,0,0,209,23-04-2022
PUDUCHERRY,598,KARAIKAL,1370,56,0,1426,23-04-2022
PUDUCHERRY,599,MAHE,99,18,0,117,23-04-2022
PUDUCHERRY,600,PONDICHERRY,7408,230,22,7660,23-04-2022
PUDUCHERRY,601,YANAM,75,10,0,85,23-04-2022
